111111111111111111111
100000000000300000001
102000000020300000001
100000000020300000001
100000000020300000001
100000000020300000001
100000000020300000001
100000000020300000001
100000000020000000001
100000000020000000001
100000000020000000001
100000000020000000001
100000000020000000001
100000000020000000001
100000000020000000001
100000000020000000001
100000000020000000001
100000000020000000001
100000000020000000001
100000000020000000001
100000000020000000001
111111111111111111111