1111111111111111111111111111111111111111111111111111111111111111111111111111111111111111111111111111111111
1000000000000000040000000000000000000000000000000000000000000000000000000000000000000000000000000000000001
1000010000002003040000000000000000002200000000000000000000000000000000000000000000000000000000000000000001
1000010000002003040000000000000000002200000000000000000000000000000000000000000000000000000000000000000001
1000020000002003040000000000000000000000000044400000000000000000000000000000000000000000000000000000000001
1000020000002003040000000000010101000000000044400000000000000000000000000000000000000000000000000000000001
1000020000002003040000000000000000000000000000000000000000033000000000000000000000000000000000000000000001
1000020000002003040000000000000000002200000000000000000000000000000000000000000000000000000000000000000001
1000020000002003040000000000000000000000000044400000000000000000000000000000000000000000000000000000000001
1000010000002003000000000000010101000000000044400000000000000000000000000000000000000000000000000000000001
1000000000000003000000000000000000000000000000000000000000033000000000000000000000000000000000000000000001
1111111111111111111111111111111111111111111111111111111111111111111111111111111111111111111111111111111111